11111111111111111
1CCCCC01C01000001
10000001001100001
10000000001110001
10E00000001110001
10000000E01110001
1000CCC0P01110001
1000C0C0C00010001
1CCCC111100010001
1CCCC110001110001
1CCCC110001110001
1CCCC110001110001
1CCCC110001110001
1CCCC110001110001
1CCCC110001110001
1CCCC110001110001
1CCCC110001110001
1CCCC110001110001
1CCCC110001110001
1CCCC110001110001
11111111111111111