1111111111111
100000010C111
100000P101101
1000000000001
1000011110001
1000000000001
1111111111111