00000000000000
00000010000000
00000111100000
01111000C00011
00000111110001
11111111111111