1111111111111
1CCCCCE1C00C1
1000000100111
1000000000111
1000000000111
1000000000111
1000000000111
10000000C0001
1CCCC11110001
1CCCC11P00111
1000000000001
1000000000001
1000000000001
1000000000001
1000000000001
1000000000001
1000000000001
1000000000001
1000000000001
1000000000001
1111111111111