1111111111111
10000001C00C1
10C0000110111
10000000C0001
1000011110001
10C0011P00111
1111111111111