11111111111111111111111111111111111111111111111
1CCPCCCCCCCCCCCCCC100000000000000000000000000E1
1CCCCCCCCCCCCCCCCC100C0000000000000000000000001
1CCCCCCCCCCCCCCCCC0000000000A000CCCCCCCCC000001
1CCCCCCCCCCCCCCCCC1CC0000000000000000C000000001
1CCCCCCCCCCCCCCCCC10000000000000000000000000001
11111111111111111111111111111111111111111111111