111111111111111111111111111111111111111111111111111111111111
100000000000000000000000000000000000000000001000000000000001
100000000000000000000000000000000000000000001000000000000001
100000000000000000000000000000000000000000001000000000000001
100000000000000000A00000000000000000000000001000000000000001
100000000000000000000000000000000000000000001000000000000001
100000000000000000000000000000000000000000001000000000000001
100000000000C000000000000000000000000000000010000A0000000001
100000000000000000000000000000000000000000001000000000000001
100000000000000000000000000000000000000000001000000000000001
1000000000000000000000000000000E000000A000001000000000000001
10000000000000000000001000P000000000000000000000000000000001
10000000000000000AA00010000000000000000000000000000000000001
100000000000000000000010000000000000000000000000000000000001
100000000000000000000010000000000000000000000000000000000001
100000000000000000000010000000000000000000000000000000000001
100000000000000000000010000000000000000000000000000000000001
100000000000000000000010000000000000000000000000000000000001
1CCCCCCCCCCCCCCCCCCCCC10000000000000000000000000000000000001
1CCCCCCCCCCCCCCCCCCCCC100000000A0000000000000000000000000001
1CCCCCCCCCCCCCCCCCCCCC100000000000000000000000000A0000000001
1CCCCCCCCCCCCCCCCCCCCC10000000000000000000000000000000000001
111111111111111111111111111111111111111111111111111111111111