1111111111111
1000000000111
1000000001101
100000C000001
1000011110001
10000000C0001
1111111111111