1111111111111
1000000000111
1000000001101
10C0000000001
1000011110001
100000000C001
1111111111111