1111111111111
1000000000111
1000000001101
1000000000001
1000011110001
1000000000001
1111111111111