1111111111111
1000000000111
1000000001101
1100000000001
1001111110001
1000000000001
1111111111111