1111111111111
1000000100001
100C000111111
10P00000C0001
1000011110001
1000000000001
1111111111111