1111111111111
1000000100001
100C000110111
10000000C0001
1000011110001
1P00000000001
1111111111111