11111111111111111111111111111111111111111111111
100000000000000000100000000000000000000000000E1
100000000000000000100C0000000000000000000000001
10000000000000000000000000000000000000000000001
10000000000000000010000000000000000000000000001
1P000000000000000010000000000000000000000000001
11111111111111111111111111111111111111111111111