1111111111111
1000000100001
1000000110111
10000000C0001
1000011110001
100C011P00111
1111111111111