11111111111111111
1CCCCCE1C00C00001
10000001001100001
10000000001110001
10000000001110001
10000000001110001
100000P0001110001
10000000C00010001
1CCCC111100010001
1CCCC110001110001
11111111111111111