1111111111111
10000001P0001
100C000110111
10000000C0001
1000011110001
1000000000001
1111111111111