1111111111111
1CCCCCE1C00C1
1011100100111
10000000C0001
1CCCC11110001
1CCCC11P00111
1111111111111