111111111111111111111111111111111111111111111111111111111111
100000000000000000000000000000000000000000001000000000000001
100000000000000000000000000000000000000000001000000000000001
100000000000000000000000000000000000000000001000000000000001
100000000000000000000000000000000000000000001000000000000001
100000000000000000000000000000000000000000001000000000000001
100000000000000000000000000000000000000000001000000000000001
100000000000C00000000000000000000000000000001000000000000001
100000000000000000000000000000000000000000001000000000000001
100000000000000000000000000000000000000000001000000000000001
1000000000000000000000000000000E0000000000001000000000000001
10000000000000000000001000P000000000000000000000000000000001
100000000000000000000010000000000000000000000000000000000001
100000000000000000000010000000000000000000000000000000000001
100000000000000000000010000000000000000000000000000000000001
100000000000000000000010000000000000000000000000000000000001
100000000000000000000010000000000000000000000000000000000001
100000000000000000000010000000000000000000000000000000000001
1CCCCCCCCCCCCCCCCCCCCC10000000000000000000000000000000000001
1CCCCCCCCCCCCCCCCCCCCC10000000000000000000000000000000000001
1CCCCCCCCCCCCCCCCCCCCC10000000000000000000000000000000000001
1CCCCCCCCCCCCCCCCCCCCC10000000000000000000000000000000000001
111111111111111111111111111111111111111111111111111111111111